





------
-OR-G-
BG-OR-
------
B-----



GR-R
--GB
B---



R---------Y
OB--------G
----------M
S--------G-
--VP-O-----
-P---------
----CS-B---
--M----FR--
----Y------
---------F-
VC---------





